1111111111111111111111111111111111
1000000000000000000W00000000000001
1010010100100000101001000000010101
1010010010101010001001000000010101
1000P00000000000000000000000000001
1111111111111111111111111111111111
